00000000000000000000000000M00B00
000LMG000000000X0023340000111111
111111100N0000000000MOS0L0000000
00000O0067800DRN0N00677778000UK0
00000O0000002222220000JBBB006780
0000678000000000O000023333400000
0000000000000000O000000000P00000
0U0A00C0000000233340000000O00000
0222222006780000000AI000S0O0Q000
00O00000000006778023400677778W00
00O00000000000000000003000000000
00P0DR00678000000002340000000000
06777780000V0233340000000DH02220
0000000000000P000000000233400000
000B000680000O0RGC00680000000E00
00023400B006777777800000A0002400
00200000680000X000000Y0068000000
20000000000000000000000000000000
0200000R0H0F000000000000000T0000
11111111111111111111111111111111